111111111111111
100000C000C0001
1P000C0E0C00X01
100000C000C0001
111111111111111