11111111
1YPCCC01
1000M0E1
11111111