11111000111
1P000CC00E1
00000000000
11111111111