11111111
1YPCCC01
100WM0E1
11111111