11111111111111111111111111111
100C00C0000010000C00001000001
1111111000C000000C01111111001
10000C00000000C00000111110C01
1P0000000111110000000000000E1
11111111111111111111111111111