11111111111111111111111
100C00C0000010000C00001
1111111000C000000C01111
10000C00000000C00000111
1P0000000111110000000E1
11111111111111111111111