111111111111111
1000CCC0CCC0001
100C000C000C001
100C0000000C001
100C000P000C001
1000C00000C0001
10000C000C00001
100000C0C000001
1000000C00000E1
111111111111111