111111111111111111
1P00C00C00C00C00E1
111111111111111111